NO img/north.xpm

SO img/south.xpm

WE img/west.xpm

EA img/east.xpm


F 255,255,255
C 90,20,10

11111
100N1
10001
11111