    NO img/north.xpm
	SO img/south.xpm
WE          img/west.xpm
EA img/east.xpm
F 255,255,255
C        90,20,10
1111111111111111111111111
1000000000110000000000001
1011000001110000000000001
1001000000000000000000001
111111111011000001110001
10000000001100000111111111111111
11110111111111011100000000001
11110111111111011111111110001
11000000110101011100000020001
10000000000000001100011110001
10000000000000001101010020001
11000001110101011111011110N0111
11110111 1110101 101111010001
11111111 1111111 111111111111