    NO img/north.xpm
	SO img/south.xpm
WE          img/west.xpm
EA img/east.xpm
F 255,255,255
C        90,20,10
1111111111111111111111111
1000000000110000000000001
1011000001110000000000001
1001000000000000000000001
111111111011000001110001
10000000001100000111111111111111
11110111000011010000000000001
11110111111011011121111111111
11000000110101011100000020001
10000110000000001100011110D01
10010110000000011010000020001
11020001110101011111011110N0111
11110120D1110101 101111010001
1111111111111111 111111111111