    NO img/north.xpm
	SO img/south.xpm
WE          img/west.xpm
EA img/east.xpm
F 255,255,255
C        90,20,10
111111111111111111111111111111111111
1100001000000000000110000100000001S1
112110111111000110011201110112110101
110100000001001100110010000000001001
110111000011000121000000000111110001
100100000000000221011000000001000101
101D11111100100110011001121111010101
100210001110100110111011122111001101
111110001120100110011000112111110201
110112111110000000110011000000000011
110200000000000110011001100111020101
111111111111111111111111111111111111
