    NO img/north.xpm
F  255,255,255
	SO img/south.xpm
WE          img/west.xpm





EA img/east.xpm
	C        90,20,10
           
		   
1111111111111111111111111
1000000000110000000000001
1011000001110000000000001
1001000000000000000000001
111111111011000001110001
100000000011000001110111111111111
11110111111111011100000000001
11110111111111011101010010001
11000000110101011100000010001
10000000000000001100000010001
10000000000000001101010010001
11000001110101011111011110S0111
11110111 1110101 10111101001
11111111 1111111 111111111111